NO textures/simonkraft/wet_sponge.xpm
SO textures/simonkraft/wet_sponge.xpm
WE textures/simonkraft/wet_sponge.xpm
EA textures/simonkraft/wet_sponge.xpm

F 105,105,105
C 135,206,250

11111111
111000111111111111111
11000000000000000111111
111000000000000000011111
1110000000000000000011111
11000000000000000111111
111000000000000000011111
1100000000S000000111111
111000000000000000011111
11000000000000000111111
111000000000000000011111
111111111111111111111111
   111111
